[EkoScape/v1]
60 Seconds
Bradley

10 5

' '
60000

!!!!!!!!!!!!!!!!!!!!
!>                 !
! !!! !!!!!! !!!!! !
! !@! !xxxx! !xxx! !
! ! ! !xxxx! !!!!! !
! ! ! !xxxx! !@    !
! ! ! !!!!!! !!!!!!!
! ! !!!           @!
! !   ! !!!!!!!!!!!!
! !   ! !@        $!
! !   ! !!! !!!!!!!!
!    !  !!! !!!!!!!!
!   !  !!@!        !
!  !  !x! !!!!!!!! !
!!!  !xx! !xxxxxx! !
!   !!!!! !!!!!!!! !
!                  !
!!!!!!!!!!!!!!!!!!!!
