[EkoScape/v1]
Hidden Treasure 2.0
Bradley

8 8

'*'
1000

#########################
############0############
##w *w *w *w *w *w *w *##
##*w *w *w *w *w *w *w ##
## *w *w *w *w *w *w *w##
##w *w###### ######*w *##
##*w *#!!!!!!!!!!!# *w ##
#1 *w #&&&@&&&&$&&#w *w1#
##w *w#############*w *##
##*w *w *w *w *w *w *w ##
## *w *w *w *w *w *w *w##
#:w *w *w *w *w ^w *w *:#
##:#########0#########:##
#########################
