[EkoScape/v1]
Hidden Treasure 2.0
Bradley

10 5

'w' ' ' '*'
1000

#####################
# *w *w *w *w *w *w #
#w *w *w *w *w *w *w#
#*w *w *w *w *w *w *#
# *w###### ######*w #
#w *#!!!!!!!!!!!# *w#
#*w #&&&@&&&&$&&#w *#
# *w#############*w #
#w *w *w *w *w *w *w#
#*w *w *w *w *w *w *#
# *w *w *w *w^*w *w #
#####################
