[EkoScape/v1]
Hidden Treasure
Bradley

10 5

' '
2000

#####################
#                   #
#                   #
#  !!!!!!!!!!!!!!!  #
#  !     &$&     !  #
#  !     &&&     !  #
#  !!!!!!!!!!!!!!!  #
#                   #
#                   #
#         ^         #
#####################
