[EkoScape/v1]
Hidden Treasure
Bradley

9 6

' '
2400

#########################
#:          0          :#
#                       #
#                       #
#    !!!!!!!!!!!!!!!    #
#    !     &$&     !    #
#1   !     &&&     !   1#
#    !     &@&     !    #
#    !!!!!!!!!!!!!!!    #
#                       #
#                       #
#           ^           #
#:          0          :#
#########################
